EA ./images/wall1.png                 

WE ./images/wall2.png                   

NO  ./images/wall3.png            

SO ./images/wall4.png

C 210,204,193           

F    170,152,125 


1111111111111111111111111111111111       
11001 10000000000000000000000000001      
1100010000000000000000000111111111       
1011000000000000100000000111                   
10000000000000000000000001111                  
1000000N00000000100000001111                   
1100000000000001 10000001111                   
1000000000000001 1000000001111                 
11111111000000001000000001111                  
1111111111111111111111111111                   
 